Абакан - abakan
Адлер - adler
Актау - aktau
Актобе - aktobe
Алматы - almaty
Альметьевск - almetevsk
Анапа - anapa
Анжеро-Судженск - anjerosudjensk
Армавир - armavir
Арсеньев - arseniev
Архангельск - arkhangelsk
Астрахань - astrakhan
Атырау - atiray
Баку - baku
Балаково - balakovo
Барнаул - barnaul
Белгород - belgorod
Белебей - belebey
Бишкек - bishkek
Благовещенск - tambov
Брянск - bryansk
Бугульма - bugulma
Великие Луки - velikieluki
Великий Новгород - velikiynovgorod
Владивосток - vladivostok
Владикавказ - vladikavkaz
Владимир - vladimir
Волгоград - volgograd
Волжский - volzhskiy
Вологда - vologda
Воронеж - voronezh
Геленджик - gelendjik
Грозный - groznyy
Гудермес - gudermes
Дербент - derbent
Джалал-Абад - djalalabad
Евпатория - evpatoriya
Ейск - eysk
Екатеринбург - ekaterinburg
Ереван - erevan
Ессентуки - essentuki
Железноводск - zheleznovodsk
Иваново - ivanovo
Ижевск - izhevsk
Ирбит - irbit
Иркутск - irkutsk
Ишим - ishim
Йошкар-Ола - yoshkarola
Казань - kazan
Калининград - kaliningrad
Калуга - kaluga
Каменск-Уральский - kamenskuralskiy
Камышин - kamyshin
Караганда - karaganda
Качканар - kachnakar
Кемерово - kemerovo
Кинешма - kineshma
Киров - kirov
Кисловодск - kislovodsk
Ковров - kovrov
Кокшетау - kokshetau
Комсомольск-на-Амуре - komsomolsknaamure
Костанай - kostanay
Кострома - kostroma
Котлас - kotlas
Краснодар - krasnodar
Красноярск - krasnoyarsk
Кропоткин - kropotkin
Курган - kurgan
Курск - kursk
Кызылорда - kizilorda
Лабытнанги - labitnangi
Лениногорск - leninogorsk
Ленинск-Кузнецкий - leninskkuznetskii
Лермонтов - lermontov
Лесной - lesnoy
Липецк - lipetsk
Магнитогорск - magnitogorsk
Майкоп - maikop
Махачкала - mahachkala
Междуреченск - mezhdurechensk
Минеральные Воды - mineralnyevody
Минск - minsk
Мончегорск - monchegorsk
Москва - msk
Мурманск - murmansk
Муром - murom
Набережные Челны - naberezhnyechelny
Нальчик - nalchik
Нефтекамск - neftekamsk
Нефтеюганск - neftuygansk
Нижневартовск - nizhnevartovsk
Нижнекамск - nijnekamsk
Нижний Новгород - nizhniynovgorod
Нижний Тагил - nizhniytagil
Новокузнецк - novokuznetsk
Новороссийск - novorossiysk
Новосибирск - novosibirsk
Новоуральск - novouralsk
Новый Уренгой - noviyurengoy
Ноябрьск - noyabrsk
Нур-Султан (Астана) - astana
Октябрьский - oktyabrskiy
Омск - omsk
Орел - orel
Оренбург - orenburg
Орск - orsk
Ош - osh
Павлодар - pavlodar
Пенза - penza
Первоуральск - pervouralsk
Пермь - perm
Петрозаводск - petrozavodsk
Петропавловск - petropavlovsk
Петропавловск-Камчатский - petropavlovskkamchatskii
Полысаево - polisaevo
Псков - pskov
Пятигорск - pyatigorsk
Раменское - ramenskoe
Ревда - revda
Ростов-на-Дону - rostovnadonu
Рыбинск - ribinsk
Рязань - ryazan
Салават - salavat
Салехард - salehard
Самара - samara
Санкт-Петербург - spb
Саранск - saransk
Саратов - saratov
Севастополь - sevastopol
Северодвинск - severodvinsk
Семей - semey
Серов - serov
Симферополь - simferopol
Смоленск - smolensk
Сочи - sochi
Ставрополь - stavropol
Старый Оскол - staryyoskol
Стерлитамак - sterlitamak
Сургут - surgut
Сухум - sukhum
Сыктывкар - sivtivkar
Тамбов - tambov
Тараз - taraz
Ташкент - tashkent
Тбилиси - tbilisi
Тверь - tver
Тобольск - tobolsk
Тольятти - tolyatti
Томск - tomsk
Туапсе - tuapse
Туймазы - tuymazy
Тула - tula
Тюмень - tyumen
Улан-Удэ - ulanude
Ульяновск - ulyanovsk
Уральск - uralsk
Усть-Каменогорск - ustkamenogorsk
Уфа - ufa
Хабаровск - khabarovsk
Ханты-Мансийск - khantymansiysk
Чебоксары - cheboksary
Челябинск - chelyabinsk
Череповец - cherepovets
Черкесск - cherkessk
Чита - chita
Шарья - sharya
Шымкент - shymkent
Элиста - elista
Южно-Сахалинск - yuzhnosakhalinsk
Юрга - yurga
Якутск - yakutsk
Ярославль - yaroslavl
